..........................................................................................
..........................................................................................
.........---------------------------------------------------------------------............
......../....................................................................|............
......./...............................>......................................\...........
......|........................................................................|..........
......|.........................................................................\.........
......|.............###..........................................................\........
......|.............###...........................................................|.......
......|.............##1...........................................................|.......
......|...........................................................................|.......
......|...........................................................................|.......
......|....................................@......................................|.......
.......\..........................................................................|.......
........\.........................................................................|.......
.........\........................................................................|.......
..........\.......................................................................|.......
...........\......................................................................|.......
............\.....................................................................|.......
.............---..................................................................|.......
................\.................................................................|.......
.................---..............................................................|.......
....................\.............................................................|.......
.....................\.........................................................../........
......................------..................................................../.........
............................\.................................................--..........
.............................\.............................................../............
..............................---...........................................-.............
.................................\........................................./..............
..................................-......................................--...............
...................................\..................................../.................
....................................------------------------------------..................
..........................................................................................
..........................................................................................
..........................................................................................
..........................................................................................